amphipoda	amphipod	fauna
amphipods	amphipod	fauna
beach	beach	Littoral Active Zone
beach exposure	beach exposure	morphodynamic state
beach exposures	beach exposure	morphodynamic state
beach slope	beach slope	morphodynamic state
beach slopes	beach slope	morphodynamic state
beach width	beach width	morphodynamic state
beach widths	beach width	morphodynamic state
beaches	beach	Littoral Active Zone
beetle	beetle	fauna
beetles	beetle	fauna
bird nest	bird nest	fauna
bird nests	bird nest	fauna
clam	clam	fauna
clams	clam	fauna
donacid clams	clam	fauna
dune	dune	Littoral Active Zone
dunes	dune	Littoral Active Zone
fauna	fauna	fauna
ghost crab	ghost crab	fauna
ghost crabs	ghost crab	fauna
indicator fauna	indicator fauna	fauna
intertidal	intertidal	Littoral Active Zone
litter	litter	litter
littoral	littoral	Littoral Active Zone
littoral active zone	littoral active zone	Littoral Active Zone
littoral active zones	littoral active zone	Littoral Active Zone
littoral zone	littoral zone	Littoral Active Zone
littoral zones	littoral zone	Littoral Active Zone
macro litter	macrolitter	litter
macro plastic	macroplastic	litter
macro plastics	macroplastic	litter
macro-litter	macrolitter	litter
macro-plastic	macroplastic	litter
macro-plastics	macroplastic	litter
macrolitter	macrolitter	litter
macroplastic	macroplastic	litter
macroplastics	macroplastic	litter
marine litter	marine litter	litter
micro litter	microlitter	litter
micro plastic	microplastic	litter
micro plastics	microplastic	litter
micro-litter	microlitter	litter
micro-plastic	microplastic	litter
micro-plastics	microplastic	litter
microlitter	microlitter	litter
microplastic	microplastic	litter
morphodynamic	morphodynamic	morphodynamic state
morphodynamics	morphodynamic	morphodynamic state
nano plastic	nanoplastic	litter
nano plastics	nanoplastic	litter
nano-plastic	nanoplastic	litter
nano-plastics	nanoplastic	litter
nanoplastic	nanoplastic	litter
plastic	plastic	litter
plastics	plastic	litter
polychaeta	polychaetes	fauna
polychaetes	polychaetes	fauna
sand grain size	sand grain size	morphodynamic state
sand grain sizes	sand grain size	morphodynamic state
shorebird	shorebird	fauna
shorebirds	shorebird	fauna
sublittoral	sublittoral	Littoral Active Zone
talitrid	talitrid amphipod	fauna
talitrid amphipod	talitrid amphipod	fauna
talitrid amphipods	talitrid amphipod	fauna
talitridae	talitrid amphipod	fauna
talitrids	talitrid amphipod	fauna
turtle	turtle	fauna
turtle nest	turtle nest	fauna
turtle nests	turtle nest	fauna
turtles	turtle	fauna